[console_scripts]
abandon = leytonium.abandon:main_abandon
agi = leytonium.refactor:main_agi
agil = leytonium.refactor:main_agil
autopull = leytonium.autopull:main_autopull
awslogs = leytonium.awslogs:main_awslogs
br = leytonium.br:main_br
brown = leytonium.brown:main_brown
ci = leytonium.ci:main_ci
co = leytonium.co:main_co
d = leytonium.shortcommands:main_d
diffuse = diffuse.main:main_diffuse
dp = leytonium.dp:main_dp
drclean = leytonium.scripts:main_drclean
drop = leytonium.scripts:main_drop
drst = leytonium.scripts:main_drst
dup = leytonium.shortcommands:main_dup
dx = leytonium.dx:main_dx
dxx = leytonium.dx:main_dxx
eb = leytonium.scripts:main_eb
examine = leytonium.scripts:main_examine
fetchall = leytonium.stmulti:main_fetchall
fixemails = leytonium.scripts:main_fixemails
gag = leytonium.shortcommands:main_gag
gimports = leytonium.scripts:main_gimports
git-completion-path = leytonium.shortcommands:main_git_completion_path
git-functions-path = leytonium.shortcommands:main_git_functions_path
gt = leytonium.gt:main_gt
halp = leytonium.halp:main_halp
hgcommit = leytonium.hgcommit:main_hgcommit
isotime = leytonium.isotime:main_isotime
ks = leytonium.ks:main_ks
mdview = leytonium.scripts:main_mdview
multimerge = leytonium.multimerge:main_multimerge
n = leytonium.n:main_n
next = leytonium.next:main_next
pb = leytonium.shortcommands:main_pb
pd = leytonium.dp:main_pd
prepare = leytonium.prepare:main_prepare
publish = leytonium.publish:main_publish
pullall = leytonium.stmulti:main_pullall
pushall = leytonium.stmulti:main_pushall
rd = leytonium.shortcommands:main_rd
rdx = leytonium.shortcommands:main_rdx
readjust = leytonium.readjust:main_readjust
reks = leytonium.scripts:main_reks
ren = leytonium.ren:main_ren
resimp = leytonium.resimp:main_resimp
rol = leytonium.rol:main_rol
rx = leytonium.shortcommands:main_rx
scrape85 = leytonium.scrape85:main_scrape85
scrub = leytonium.shortcommands:main_scrub
setparent = leytonium.setparent:main_setparent
shove = leytonium.shove:main_shove
show = leytonium.show:main_show
showstash = leytonium.shortcommands:main_showstash
slam = leytonium.slam:main_slam
splitpkgs = leytonium.splitpkgs:main_splitpkgs
squash = leytonium.scripts:main_squash
st = leytonium.st:main_st
stacks = leytonium.stacks:main_stacks
stmulti = leytonium.stmulti:main_stmulti
taskding = leytonium.taskding:main_taskding
tempvenv = leytonium.tempvenv:main_tempvenv
touchb = leytonium.touchb:main_touchb
unpub = leytonium.unpub:main_unpub
unslam = leytonium.slam:main_unslam
upgrade = leytonium.upgrade:main_upgrade
vpn = leytonium.scripts:main_vpn
vunzip = leytonium.scripts:main_vunzip

