[console_scripts]
rb-site = reviewboard.cmdline.rbsite:main
rbext = reviewboard.cmdline.rbext:main
rbssh = reviewboard.cmdline.rbssh:main

[reviewboard.auth_backends]
ad = reviewboard.accounts.backends.ad:ActiveDirectoryBackend
digest = reviewboard.accounts.backends.http_digest:HTTPDigestBackend
ldap = reviewboard.accounts.backends.ldap:LDAPBackend
nis = reviewboard.accounts.backends.nis:NISBackend
x509 = reviewboard.accounts.backends.x509:X509Backend

[reviewboard.hosting_services]
assembla = reviewboard.hostingsvcs.assembla:Assembla
beanstalk = reviewboard.hostingsvcs.beanstalk:Beanstalk
bitbucket = reviewboard.hostingsvcs.bitbucket:Bitbucket
bugzilla = reviewboard.hostingsvcs.bugzilla:Bugzilla
codebasehq = reviewboard.hostingsvcs.codebasehq:CodebaseHQ
fedorahosted = reviewboard.hostingsvcs.fedorahosted:FedoraHosted
fogbugz = reviewboard.hostingsvcs.fogbugz:FogBugz
gerrit = reviewboard.hostingsvcs.gerrit:Gerrit
github = reviewboard.hostingsvcs.github:GitHub
gitlab = reviewboard.hostingsvcs.gitlab:GitLab
gitorious = reviewboard.hostingsvcs.gitorious:Gitorious
googlecode = reviewboard.hostingsvcs.googlecode:GoogleCode
jira = reviewboard.hostingsvcs.jira:JIRA
kiln = reviewboard.hostingsvcs.kiln:Kiln
rbgateway = reviewboard.hostingsvcs.rbgateway:ReviewBoardGateway
redmine = reviewboard.hostingsvcs.redmine:Redmine
sourceforge = reviewboard.hostingsvcs.sourceforge:SourceForge
splat = reviewboard.hostingsvcs.splat:Splat
trac = reviewboard.hostingsvcs.trac:Trac
unfuddle = reviewboard.hostingsvcs.unfuddle:Unfuddle
versionone = reviewboard.hostingsvcs.versionone:VersionOne

[reviewboard.scmtools]
bzr = reviewboard.scmtools.bzr:BZRTool
clearcase = reviewboard.scmtools.clearcase:ClearCaseTool
cvs = reviewboard.scmtools.cvs:CVSTool
git = reviewboard.scmtools.git:GitTool
hg = reviewboard.scmtools.hg:HgTool
perforce = reviewboard.scmtools.perforce:PerforceTool
plastic = reviewboard.scmtools.plastic:PlasticTool
svn = reviewboard.scmtools.svn:SVNTool

